17
214
-1 0  0  0  0  0  0 0 0 0  0  0  0  0  0  0  0  0  0  0  0  0  0  0 0  0  0  0 0  0  0  0  0  0 0 0 0 0  0  0  0  0 0  0  0  0  0 0  0  0  0  0  0  0  0 0 0 0  0  0  0  0  0  0  0  0  0  0  0  0  0  0 0  0  0  0 0  0  0  0  0  0 0 0 0 0  0  0  0  0 0  0  0  0  0 0 0 0  0  0  0  0  0 0 0 0  0  0  0  0  0  0  0  0  0  0  0  0  0  0 0  0  0  0 0 0  0  0  0  0  0 0 0 0 0  0  0  0  0 0 0  0  0 0 0 0 0  0  0  0  0 0 0 0 0  0  0  0 0 0 0 0  0  0  0  0  0  0  0 0  0  0  0 0  0  0  0  0  0 0 0 0  0  0  0  0  0 0 0 0 0 0 0 0 0  0  0  0  0  0 0  0 0  0  0  0  0  0  0  0  0  0  0  -1
-1 0  0  0  0  0  0 0 0 0  0  0  0  0  0  0  0  0  0  0  0  0  0  0 0  0  0  0 0  0  0  0  0  0 0 0 0 0  0  0  0  0 0  0  0  0  0 0  0  0  0  0  0  0  0 0 0 0  0  0  0  0  0  0  0  0  0  0  0  0  0  0 0  0  0  0 0  0  0  0  0  0 0 0 0 0  0  0  0  0 0  0  0  0  0 0 0 0  0  0  0  0  0 0 0 0  0  0  0  0  0  0  0  0  0  0  0  0  0  0 0  0  0  0 0 0  0  0  0  0  0 0 0 0 0  0  0  0  0 0 0  0  0 0 0 0 0  0  0  0  0 0 0 0 0  0  0  0 0 0 0 0  0  0  0  0  0  0  0 0  0  0  0 0  0  0  0  0  0 0 0 0  0  0  0  0  0 0 0 0 0 0 0 0 0  0  0  0  0  0 0  0 0  0  0  0  0  0  0  0  0  0  0  -1
-1 0  0  0  0  0  0 0 0 0  0  0  0  0  0  0  0  0  0  0  40 41 42 0 0  0  0  0 0  0  0  0  0  0 0 0 0 40 41 41 42 0 0  0  0  0  0 0  0  0  0  0  0  0  0 0 0 0  0  0  0  0  0  0  0  0  0  0  40 41 42 0 0  0  0  0 0  0  0  0  0  0 0 0 0 40 41 41 42 0 0  0  0  0  0 0 0 0  0  0  0  0  0 0 0 0  0  0  0  0  0  0  0  0  0  0  40 41 42 0 0  0  0  0 0 0  0  0  0  0  0 0 0 0 40 41 41 42 0 0 0  0  0 0 0 0 0  0  0  0  0 0 0 0 0  0  0  0 0 0 0 0  0  0  0  40 41 42 0 0  0  0  0 0  0  0  0  0  0 0 0 0  40 41 41 42 0 0 0 0 0 0 0 0 0  0  0  0  0  0 31 0 0  0  0  0  0  0  0  0  0  0  0  -1
-1 0  0  0  0  0  0 0 0 40 41 42 0  0  0  0  0  0  0  0  43 44 45 0 0  0  0  0 40 41 41 41 42 0 0 0 0 43 44 44 45 0 0  0  0  0  0 0  0  0  0  0  0  0  0 0 0 40 41 42 0  0  0  0  0  0  0  0  43 44 45 0 0  0  0  0 40 41 41 41 42 0 0 0 0 43 44 44 45 0 0  0  0  0  0 0 0 0  0  0  0  0  0 0 0 40 41 42 0  0  0  0  0  0  0  0  43 44 45 0 0  0  0  0 0 40 41 41 41 42 0 0 0 0 43 44 44 45 0 0 0  0  0 0 0 0 0  0  0  0  0 0 0 0 40 41 42 0 0 0 0 0  0  0  0  43 44 45 0 0  0  0  0 40 41 41 41 42 0 0 0 0  43 44 44 45 0 0 0 0 0 0 0 0 0  0  0  0  0  0 30 0 40 41 42 0  0  0  0  0  0  0  0  -1
-1 0  0  0  0  0  0 0 0 43 44 45 0  0  0  0  0  0  0  0  0  0  0  0 0  0  0  0 43 44 44 44 45 0 0 0 0 0  0  0  0  0 0  0  0  0  0 0  0  0  0  0  0  0  0 0 0 43 44 45 0  0  0  0  0  0  0  0  0  0  0  0 0  0  0  0 43 44 44 44 45 0 0 0 0 0  0  0  0  0 0  0  0  0  0 0 0 0  0  0  0  0  0 0 0 43 44 45 0  0  0  0  0  0  0  0  0  0  0  0 0  0  0  0 0 43 44 44 44 45 0 0 0 0 0  0  0  0  0 0 0  0  0 0 0 0 0  0  0  0  0 0 0 0 43 44 45 0 0 0 0 0  0  0  0  0  0  0  0 0  0  0  0 43 44 44 44 45 0 0 0 0  0  0  0  0  0 0 0 0 0 0 0 0 0  0  0  0  0  0 30 0 43 44 45 0  0  0  0  0  0  0  0  -1
-1 0  0  0  0  0  0 0 0 0  0  0  0  0  0  0  0  0  0  0  0  0  0  4 0  0  0  0 0  0  0  0  0  0 0 0 0 0  0  0  0  0 0  0  0  0  0 0  0  0  0  0  0  0  0 0 0 0  0  0  0  0  0  0  0  0  0  0  0  0  0  0 0  0  0  0 0  0  0  0  0  2 2 2 2 2  2  2  2  0 0  0  2  2  2 4 0 0  0  0  0  0  0 0 0 0  0  0  0  0  4  0  0  0  0  0  0  0  0  0 0  0  0  2 2 2  0  0  0  0  2 4 4 2 0  0  0  0  0 0 0  0  0 0 0 0 0  0  0  0  0 0 0 0 0  0  0  0 0 0 0 0  0  0  0  0  0  0  0 0  0  0  0 0  0  0  0  0  0 0 0 0  0  0  0  0  0 0 0 0 6 6 0 0 0  0  0  0  0  0 30 0 0  0  0  0  0  0  0  0  0  0  0  -1
-1 0  0  0  0  0  0 0 0 0  0  0  0  0  0  0  0  0  0  0  0  0  0  0 0  0  0  0 0  0  0  0  0  0 0 0 0 0  0  0  0  0 0  0  0  0  0 0  0  0  0  0  0  0  0 0 0 0  0  0  0  0  0  0  0  0  0  0  0  0  0  0 0  0  0  0 0  0  0  0  0  0 0 0 0 0  0  0  0  0 0  0  0  0  0 0 0 0  0  0  0  0  0 0 0 0  0  0  0  0  0  0  0  0  0  0  0  0  0  0 0  0  0  0 0 0  0  0  0  0  0 0 0 0 0  0  0  0  0 0 0  0  0 0 0 0 0  0  0  0  0 0 0 0 0  0  0  0 0 0 0 0  0  0  0  0  0  0  0 0  0  0  0 0  0  0  0  0  0 0 0 0  0  0  0  0  0 0 0 6 6 6 0 0 0  0  0  0  0  0 30 0 0  0  0  0  0  0  0  0  0  0  0  -1
-1 0  0  0  0  0  0 0 0 0  0  0  0  0  0  0  0  0  0  0  0  0  0  0 0  0  0  0 0  0  0  0  0  0 0 0 0 0  0  0  0  0 0  0  0  0  0 0  0  0  0  0  0  0  0 0 0 0  0  0  0  0  0  0  0  0  0  0  0  0  0  0 0  0  0  0 0  0  0  0  0  0 0 0 0 0  0  0  0  0 0  0  0  0  0 0 0 0  0  0  0  0  0 0 0 0  0  0  0  0  0  0  0  0  0  0  0  0  0  0 0  0  0  0 0 0  0  0  0  0  0 0 0 0 0  0  0  0  0 0 0  0  0 0 0 0 0  0  0  0  0 0 0 0 0  0  0  0 0 0 0 0  0  0  0  0  0  0  0 0  0  0  0 0  0  0  0  0  0 0 0 0  0  0  0  0  0 0 6 6 6 6 0 0 0  0  0  0  0  0 30 0 0  0  0  0  0  0  0  0  0  0  0  -1
-1 0  0  0  0  0  0 0 0 0  0  0  0  0  0  0  0  0  0  0  0  0  0  0 0  0  0  0 0  0  0  0  0  0 0 0 0 0  0  0  0  0 0  0  0  0  0 0  0  0  0  0  0  0  0 0 0 0  0  0  0  0  0  0  0  0  0  0  0  0  0  0 0  0  0  0 0  0  0  0  0  0 0 0 0 0  0  0  0  0 0  0  0  0  0 0 0 0  0  0  0  0  0 0 0 0  0  0  0  0  0  0  0  0  0  0  0  0  0  0 0  0  0  0 0 0  0  0  0  0  0 0 0 0 0  0  0  0  0 0 0  0  0 0 0 0 0  0  0  0  0 0 0 0 0  0  0  0 0 0 0 0  0  0  0  0  0  0  0 0  0  0  0 0  0  0  0  0  0 0 0 0  0  0  0  0  0 6 6 6 6 6 0 0 0  0  0  0  0  0 30 0 0  0  0  32 32 32 0  0  0  0  0  -1
-1 0  0  0  0  0  0 0 0 0  0  0  0  0  0  0  0  4  0  0  0  2  4  2 4  2  0  0 0  0  0  0  0  0 0 0 0 0  0  0  0  0 0  0  0  0  0 20 21 0  0  0  0  0  0 0 0 0  20 21 0  0  0  0  0  0  0  0  0  0  0  0 0  0  0  0 0  0  2  4  2  0 0 0 0 0  0  0  0  0 0  0  0  0  0 2 0 0  0  0  0  2  2 0 0 0  0  4  0  0  4  0  0  4  0  0  0  0  0  2 0  0  0  0 0 0  0  0  0  0  0 2 2 0 0  0  0  0  0 6 0  0  6 0 0 0 0  0  0  0  0 0 0 6 6  0  0  6 0 0 0 0  0  0  0  0  0  0  0 0  2  2  4 2  0  0  0  0  0 0 0 0  0  0  0  0  6 6 6 6 6 6 0 0 0  0  0  0  0  0 30 0 0  0  0  35 1  36 0  0  0  0  0  -1
-1 0  0  11 0  0  0 0 0 0  0  0  0  0  0  0  0  0  0  0  0  0  0  0 0  0  0  0 0  0  0  0  0  0 0 0 0 0  0  20 21 0 0  0  0  0  0 22 23 0  0  11 0  0  0 0 0 0  22 23 0  0  0  0  0  0  0  0  0  0  0  0 0  0  0  0 0  0  0  0  0  0 0 0 0 0  0  0  0  0 0  0  0  0  0 0 0 0  0  11 0  0  0 0 0 0  0  0  0  0  0  0  0  0  0  0  0  0  0  0 0  0  0  0 0 0  0  0  0  0  0 0 0 0 0  0  0  0  6 6 0  0  6 6 0 0 0  0  11 0  0 0 6 6 6  0  0  6 6 0 0 0  0  0  0  0  0  0  0 0  0  0  0 0  0  0  0  0  0 0 0 0  0  0  0  6  6 6 6 6 6 6 0 0 0  0  11 0  0  0 30 0 0  0  32 33 33 33 32 0  0  0  0  -1
-1 0  12 15 14 0  0 0 0 0  0  0  0  0  0  0  0  0  11 0  0  0  0  0 0  0  0  0 0  20 21 0  0  0 0 0 0 0  0  22 23 0 0  0  0  0  0 22 23 0  12 15 14 0  0 0 0 0  22 23 0  0  0  0  0  0  11 0  0  0  0  0 0  0  0  0 0  0  0  0  0  0 0 0 0 0  0  0  0  0 0  0  0  0  0 0 0 0  12 15 14 0  0 0 0 0  0  0  0  0  0  0  0  0  11 0  0  0  0  0 0  0  0  0 0 0  0  0  0  0  0 0 0 0 0  0  0  6  6 6 0  0  6 6 6 0 0  12 15 14 0 6 6 6 6  0  0  6 6 6 0 0  0  11 0  20 21 0  0 0  0  0  0 0  0  0  0  0  0 0 0 20 21 0  6  6  6 6 6 6 6 6 0 0 0  12 15 14 0  0 30 0 0  0  1  1  34 1  1  0  0  11 0  -1
-1 12 15 13 16 14 0 0 0 0  0  0  17 18 18 18 19 12 15 14 0  0  0  0 17 18 19 0 0  22 23 0  0  0 0 0 0 0  0  22 23 0 17 18 18 19 0 22 23 12 15 13 16 14 0 0 0 0  22 23 17 18 18 18 19 12 15 14 0  0  0  0 17 18 19 0 0  0  0  0  0  0 0 0 0 0  0  0  0  0 17 18 18 19 0 0 0 12 15 13 16 14 0 0 0 0  0  0  17 18 18 18 19 12 15 14 0  0  0  0 17 18 19 0 0 0  0  0  0  0  0 0 0 0 0  0  6  6  6 6 18 18 6 6 6 6 12 15 13 16 6 6 6 6 6  0  0  6 6 6 6 19 12 15 14 22 23 0  0 17 18 19 0 0  0  0  0  0  0 0 0 22 23 6  6  6  6 6 6 6 6 6 0 0 12 15 13 16 14 0 6  0 0  0  1  1  37 1  1  19 12 15 14 -1
 3 3  3  3  3  3  3 3 3 3  3  3  3  3  3  3  3  3  3  3  3  3  3  3 3  3  3  3 3  3  3  3  3  3 3 3 3 3  3  3  3  3 3  3  3  3  3 3  3  3  3  3  3  3  3 3 3 3  3  3  3  3  3  3  3  3  3  3  3  3  0  0 3  3  3  3 3  3  3  3  3  3 3 3 3 3  3  0  0  0 3  3  3  3  3 3 3 3  3  3  3  3  3 3 3 3  3  3  3  3  3  3  3  3  3  3  3  3  3  3 3  3  3  3 3 3  3  3  3  3  3 3 3 3 3  3  3  3  3 3 3  3  3 3 3 3 3  3  3  3  3 3 3 3 3  0  0  3 3 3 3 3  3  3  3  3  3  3  3 3  3  3  3 3  3  3  3  3  3 3 3 3  3  3  3  3  3 3 3 3 3 3 3 3 3  3  3  3  3  3 3  3 3  3  3  3  3  3  3  3  3  3  3   3
 3 3  3  3  3  3  3 3 3 3  3  3  3  3  3  3  3  3  3  3  3  3  3  3 3  3  3  3 3  3  3  3  3  3 3 3 3 3  3  3  3  3 3  3  3  3  3 3  3  3  3  3  3  3  3 3 3 3  3  3  3  3  3  3  3  3  3  3  3  3  0  0 3  3  3  3 3  3  3  3  3  3 3 3 3 3  3  0  0  0 3  3  3  3  3 3 3 3  3  3  3  3  3 3 3 3  3  3  3  3  3  3  3  3  3  3  3  3  3  3 3  3  3  3 3 3  3  3  3  3  3 3 3 3 3  3  3  3  3 3 3  3  3 3 3 3 3  3  3  3  3 3 3 3 3  0  0  3 3 3 3 3  3  3  3  3  3  3  3 3  3  3  3 3  3  3  3  3  3 3 3 3  3  3  3  3  3 3 3 3 3 3 3 3 3  3  3  3  3  3 3  3 3  3  3  3  3  3  3  3  3  3  3   3
 3 3  3  3  3  3  3 3 3 3  3  3  3  3  3  3  3  3  3  3  3  3  3  3 3  3  3  3 3  3  3  3  3  3 3 3 3 3  3  3  3  3 3  3  3  3  3 3  3  3  3  3  3  3  3 3 3 3  3  3  3  3  3  3  3  3  3  3  3  3  0  0 3  3  3  3 3  3  3  3  3  3 3 3 3 3  3  0  0  0 3  3  3  3  3 3 3 3  3  3  3  3  3 3 3 3  3  3  3  3  3  3  3  3  3  3  3  3  3  3 3  3  3  3 3 3  3  3  3  3  3 3 3 3 3  3  3  3  3 3 3  3  3 3 3 3 3  3  3  3  3 3 3 3 3  0  0  3 3 3 3 3  3  3  3  3  3  3  3 3  3  3  3 3  3  3  3  3  3 3 3 3  3  3  3  3  3 3 3 3 3 3 3 3 3  3  3  3  3  3 3  3 3  3  3  3  3  3  3  3  3  3  3   3
 3 3  3  3  3  3  3 3 3 3  3  3  3  3  3  3  3  3  3  3  3  3  3  3 3  3  3  3 3  3  3  3  3  3 3 3 3 3  3  3  3  3 3  3  3  3  3 3  3  3  3  3  3  3  3 3 3 3  3  3  3  3  3  3  3  3  3  3  3  3 -1 -1 3  3  3  3 3  3  3  3  3  3 3 3 3 3  3 -1 -1 -1 3  3  3  3  3 3 3 3  3  3  3  3  3 3 3 3  3  3  3  3  3  3  3  3  3  3  3  3  3  3 3  3  3  3 3 3  3  3  3  3  3 3 3 3 3  3  3  3  3 3 3  3  3 3 3 3 3  3  3  3  3 3 3 3 3 -1 -1  3 3 3 3 3  3  3  3  3  3  3  3 3  3  3  3 3  3  3  3  3  3 3 3 3  3  3  3  3  3 3 3 3 3 3 3 3 3  3  3  3  3  3 3  3 3  3  3  3  3  3  3  3  3  3  3   3